CB2_Cocoa_Beach_FL	CTAACGT	CCGAATG
CB4_Cocoa_Beach_FL	TCGGTACT	CCGAATG
CB5_Cocoa_Beach_FL	GATCGTTGT	CCGAATG
CB8_Cocoa_Beach_FL	AGCTACACTT	CCGAATG
CB10_Cocoa_Beach_FL	ACGCATT	CCGAATG
NS5_New_Smyrna_FL	GTATGCAT	CCGAATG
NS6_New_Smyrna_FL	CACATGTCT	CCGAATG
NS8_New_Smyrna_FL	TGTGCACGAT	CCGAATG
NS9_New_Smyrna_FL	GCATCAT	CCGAATG
NS10_New_Smyrna_FL	ATGCTGTT	CCGAATG
JB1_Jacksonville_Beach_FL	CATGACCTT	CCGAATG
JB2_Jacksonville_Beach_FL	TGCAGTGAGT	CCGAATG
JB5_Jacksonville_Beach_FL	CTAACGT	TTAGGCAG
JB6_Jacksonville_Beach_FL	TCGGTACT	TTAGGCAG
JB7_Jacksonville_Beach_FL	GATCGTTGT	TTAGGCAG
JB9_Jacksonville_Beach_FL	AGCTACACTT	TTAGGCAG
JB10_Jacksonville_Beach_FL	ACGCATT	TTAGGCAG
JI5_Jekyll_Island_GA	GTATGCAT	TTAGGCAG
JI7_Jekyll_Island_GA	CACATGTCT	TTAGGCAG
JI8_Jekyll_Island_GA	TGTGCACGAT	TTAGGCAG
JI10_Jekyll_Island_GA	GCATCAT	TTAGGCAG
HH5_Hilton_Head_SC	ATGCTGTT	TTAGGCAG
HH6_Hilton_Head_SC	CATGACCTT	TTAGGCAG
HH7_Hilton_Head_SC	TGCAGTGAGT	TTAGGCAG
HH8_Hilton_Head_SC	CTAACGT	AACTCGTCG
HH10_Hilton_Head_SC	TCGGTACT	AACTCGTCG
FB1_Folly_Beach_SC	GATCGTTGT	AACTCGTCG
FB2_Folly_Beach_SC	AGCTACACTT	AACTCGTCG
FB10_Folly_Beach_SC	ACGCATT	AACTCGTCG
MB2_Myrtle_Beach_SC	GTATGCAT	AACTCGTCG
MB3_Myrtle_Beach_SC	CACATGTCT	AACTCGTCG
MB4_Myrtle_Beach_SC	TGTGCACGAT	AACTCGTCG
MB5_Myrtle_Beach_SC	GCATCAT	AACTCGTCG
MB7_Myrtle_Beach_SC	ATGCTGTT	AACTCGTCG
MB8_Myrtle_Beach_SC	CATGACCTT	AACTCGTCG
TB5_Topsail_Beach_NC	TGCAGTGAGT	AACTCGTCG
TB6_Topsail_Beach_NC	CTAACGT	GGTCTACGTG
TB7_Topsail_Beach_NC	TCGGTACT	GGTCTACGTG
TB8_Topsail_Beach_NC	GATCGTTGT	GGTCTACGTG
EI6_Emerald_Island_NC	AGCTACACTT	GGTCTACGTG
EI7_Emerald_Island_NC	ACGCATT	GGTCTACGTG
EI8_Emerald_Island_NC	GTATGCAT	GGTCTACGTG
EI9_Emerald_Island_NC	CACATGTCT	GGTCTACGTG
CH5_Cape_Hatteras_NC	TGTGCACGAT	GGTCTACGTG
CH6_Cape_Hatteras_NC	GCATCAT	GGTCTACGTG
CH7_Cape_Hatteras_NC	ATGCTGTT	GGTCTACGTG
CH8_Cape_Hatteras_NC	CATGACCTT	GGTCTACGTG
CH10_Cape_Hatteras_NC	TGCAGTGAGT	GGTCTACGTG
CU5_Currituck_Beach_NC	CTAACGT	GATACCTG
CU6_Currituck_Beach_NC	TCGGTACT	GATACCTG
CU7_Currituck_Beach_NC	GATCGTTGT	GATACCTG
CU8_Currituck_Beach_NC	AGCTACACTT	GATACCTG
VB5_Virginia_Beach_VA	ACGCATT	GATACCTG
VB6_Virginia_Beach_VA	GTATGCAT	GATACCTG
VB7_Virginia_Beach_VA	CACATGTCT	GATACCTG
VB8_Virginia_Beach_VA	TGTGCACGAT	GATACCTG
VB10_Virginia_Beach_VA	GCATCAT	GATACCTG
AI1_Assateague_Island_VA	ATGCTGTT	GATACCTG
AI2_Assateague_Island_VA	CATGACCTT	GATACCTG
AI5_Assateague_Island_VA	TGCAGTGAGT	GATACCTG
AI9_Assateague_Island_VA	CTAACGT	AGCGTTGG
CM5_Cape_May_NJ	TCGGTACT	AGCGTTGG
CM6_Cape_May_NJ	GATCGTTGT	AGCGTTGG
CM7_Cape_May_NJ	AGCTACACTT	AGCGTTGG
CM8_Cape_May_NJ	ACGCATT	AGCGTTGG
CM9_Cape_May_NJ	GTATGCAT	AGCGTTGG
LB1_Long_Beach_NJ	CACATGTCT	AGCGTTGG
LB3_Long_Beach_NJ	TGTGCACGAT	AGCGTTGG
LB4_Long_Beach_NJ	GCATCAT	AGCGTTGG
LB5_Long_Beach_NJ	ATGCTGTT	AGCGTTGG
LB9_Long_Beach_NJ	CATGACCTT	AGCGTTGG
SB1_Sea_Bright_NJ	TGCAGTGAGT	AGCGTTGG
SB2_Sea_Bright_NJ	CTAACGT	CTGCAACTG
NB1_Nickerson_Beach_NY	TCGGTACT	CTGCAACTG
NB2_Nickerson_Beach_NY	GATCGTTGT	CTGCAACTG
NB4_Nickerson_Beach_NY	AGCTACACTT	CTGCAACTG
NB5_Nickerson_Beach_NY	ACGCATT	CTGCAACTG
NB7_Nickerson_Beach_NY	GTATGCAT	CTGCAACTG
WH1_Watch_Hill_RI	CACATGTCT	CTGCAACTG
WH2_Watch_Hill_RI	TGTGCACGAT	CTGCAACTG
WH3_Watch_Hill_RI	GCATCAT	CTGCAACTG
WH4_Watch_Hill_RI	ATGCTGTT	CTGCAACTG
LS1_Long_Sands_ME	CATGACCTT	CTGCAACTG
LS2_Long_Sands_ME	TGCAGTGAGT	CTGCAACTG
LS3_Long_Sands_ME	CTAACGT	TCATGGTCAG
LS4_Long_Sands_ME	TCGGTACT	TCATGGTCAG
LS7_Long_Sands_ME	GATCGTTGT	TCATGGTCAG
LS9_Long_Sands_ME	AGCTACACTT	TCATGGTCAG
CR1_Crescent_Beach_ME	ACGCATT	TCATGGTCAG
CR2_Crescent_Beach_ME	GTATGCAT	TCATGGTCAG
CR3_Crescent_Beach_ME	CACATGTCT	TCATGGTCAG
CR4_Crescent_Beach_ME	TGTGCACGAT	TCATGGTCAG
PH2_Popham_Beach_ME	GCATCAT	TCATGGTCAG
PH3_Popham_Beach_ME	ATGCTGTT	TCATGGTCAG
PH5_Popham_Beach_ME	CATGACCTT	TCATGGTCAG
PH6_Popham_Beach_ME	TGCAGTGAGT	TCATGGTCAG
