CB2_Cocoa_Beach_FL	CCGAATG	CTAACGT
CB4_Cocoa_Beach_FL	CCGAATG	TCGGTACT
CB5_Cocoa_Beach_FL	CCGAATG	GATCGTTGT
CB8_Cocoa_Beach_FL	CCGAATG	AGCTACACTT
CB10_Cocoa_Beach_FL	CCGAATG	ACGCATT
NS5_New_Smyrna_FL	CCGAATG	GTATGCAT
NS6_New_Smyrna_FL	CCGAATG	CACATGTCT
NS8_New_Smyrna_FL	CCGAATG	TGTGCACGAT
NS9_New_Smyrna_FL	CCGAATG	GCATCAT
NS10_New_Smyrna_FL	CCGAATG	ATGCTGTT
JB1_Jacksonville_Beach_FL	CCGAATG	CATGACCTT
JB2_Jacksonville_Beach_FL	CCGAATG	TGCAGTGAGT
JB5_Jacksonville_Beach_FL	TTAGGCAG	CTAACGT
JB6_Jacksonville_Beach_FL	TTAGGCAG	TCGGTACT
JB7_Jacksonville_Beach_FL	TTAGGCAG	GATCGTTGT
JB9_Jacksonville_Beach_FL	TTAGGCAG	AGCTACACTT
JB10_Jacksonville_Beach_FL	TTAGGCAG	ACGCATT
JI5_Jekyll_Island_GA	TTAGGCAG	GTATGCAT
JI7_Jekyll_Island_GA	TTAGGCAG	CACATGTCT
JI8_Jekyll_Island_GA	TTAGGCAG	TGTGCACGAT
JI10_Jekyll_Island_GA	TTAGGCAG	GCATCAT
HH5_Hilton_Head_SC	TTAGGCAG	ATGCTGTT
HH6_Hilton_Head_SC	TTAGGCAG	CATGACCTT
HH7_Hilton_Head_SC	TTAGGCAG	TGCAGTGAGT
HH8_Hilton_Head_SC	AACTCGTCG	CTAACGT
HH10_Hilton_Head_SC	AACTCGTCG	TCGGTACT
FB1_Folly_Beach_SC	AACTCGTCG	GATCGTTGT
FB2_Folly_Beach_SC	AACTCGTCG	AGCTACACTT
FB10_Folly_Beach_SC	AACTCGTCG	ACGCATT
MB2_Myrtle_Beach_SC	AACTCGTCG	GTATGCAT
MB3_Myrtle_Beach_SC	AACTCGTCG	CACATGTCT
MB4_Myrtle_Beach_SC	AACTCGTCG	TGTGCACGAT
MB5_Myrtle_Beach_SC	AACTCGTCG	GCATCAT
MB7_Myrtle_Beach_SC	AACTCGTCG	ATGCTGTT
MB8_Myrtle_Beach_SC	AACTCGTCG	CATGACCTT
TB5_Topsail_Beach_NC	AACTCGTCG	TGCAGTGAGT
TB6_Topsail_Beach_NC	GGTCTACGTG	CTAACGT
TB7_Topsail_Beach_NC	GGTCTACGTG	TCGGTACT
TB8_Topsail_Beach_NC	GGTCTACGTG	GATCGTTGT
EI6_Emerald_Island_NC	GGTCTACGTG	AGCTACACTT
EI7_Emerald_Island_NC	GGTCTACGTG	ACGCATT
EI8_Emerald_Island_NC	GGTCTACGTG	GTATGCAT
EI9_Emerald_Island_NC	GGTCTACGTG	CACATGTCT
CH5_Cape_Hatteras_NC	GGTCTACGTG	TGTGCACGAT
CH6_Cape_Hatteras_NC	GGTCTACGTG	GCATCAT
CH7_Cape_Hatteras_NC	GGTCTACGTG	ATGCTGTT
CH8_Cape_Hatteras_NC	GGTCTACGTG	CATGACCTT
CH10_Cape_Hatteras_NC	GGTCTACGTG	TGCAGTGAGT
CU5_Currituck_Beach_NC	GATACCTG	CTAACGT
CU6_Currituck_Beach_NC	GATACCTG	TCGGTACT
CU7_Currituck_Beach_NC	GATACCTG	GATCGTTGT
CU8_Currituck_Beach_NC	GATACCTG	AGCTACACTT
VB5_Virginia_Beach_VA	GATACCTG	ACGCATT
VB6_Virginia_Beach_VA	GATACCTG	GTATGCAT
VB7_Virginia_Beach_VA	GATACCTG	CACATGTCT
VB8_Virginia_Beach_VA	GATACCTG	TGTGCACGAT
VB10_Virginia_Beach_VA	GATACCTG	GCATCAT
AI1_Assateague_Island_VA	GATACCTG	ATGCTGTT
AI2_Assateague_Island_VA	GATACCTG	CATGACCTT
AI5_Assateague_Island_VA	GATACCTG	TGCAGTGAGT
AI9_Assateague_Island_VA	AGCGTTGG	CTAACGT
CM5_Cape_May_NJ	AGCGTTGG	TCGGTACT
CM6_Cape_May_NJ	AGCGTTGG	GATCGTTGT
CM7_Cape_May_NJ	AGCGTTGG	AGCTACACTT
CM8_Cape_May_NJ	AGCGTTGG	ACGCATT
CM9_Cape_May_NJ	AGCGTTGG	GTATGCAT
LB1_Long_Beach_NJ	AGCGTTGG	CACATGTCT
LB3_Long_Beach_NJ	AGCGTTGG	TGTGCACGAT
LB4_Long_Beach_NJ	AGCGTTGG	GCATCAT
LB5_Long_Beach_NJ	AGCGTTGG	ATGCTGTT
LB9_Long_Beach_NJ	AGCGTTGG	CATGACCTT
SB1_Sea_Bright_NJ	AGCGTTGG	TGCAGTGAGT
SB2_Sea_Bright_NJ	CTGCAACTG	CTAACGT
NB1_Nickerson_Beach_NY	CTGCAACTG	TCGGTACT
NB2_Nickerson_Beach_NY	CTGCAACTG	GATCGTTGT
NB4_Nickerson_Beach_NY	CTGCAACTG	AGCTACACTT
NB5_Nickerson_Beach_NY	CTGCAACTG	ACGCATT
NB7_Nickerson_Beach_NY	CTGCAACTG	GTATGCAT
WH1_Watch_Hill_RI	CTGCAACTG	CACATGTCT
WH2_Watch_Hill_RI	CTGCAACTG	TGTGCACGAT
WH3_Watch_Hill_RI	CTGCAACTG	GCATCAT
WH4_Watch_Hill_RI	CTGCAACTG	ATGCTGTT
LS1_Long_Sands_ME	CTGCAACTG	CATGACCTT
LS2_Long_Sands_ME	CTGCAACTG	TGCAGTGAGT
LS3_Long_Sands_ME	TCATGGTCAG	CTAACGT
LS4_Long_Sands_ME	TCATGGTCAG	TCGGTACT
LS7_Long_Sands_ME	TCATGGTCAG	GATCGTTGT
LS9_Long_Sands_ME	TCATGGTCAG	AGCTACACTT
CR1_Crescent_Beach_ME	TCATGGTCAG	ACGCATT
CR2_Crescent_Beach_ME	TCATGGTCAG	GTATGCAT
CR3_Crescent_Beach_ME	TCATGGTCAG	CACATGTCT
CR4_Crescent_Beach_ME	TCATGGTCAG	TGTGCACGAT
PH2_Popham_Beach_ME	TCATGGTCAG	GCATCAT
PH3_Popham_Beach_ME	TCATGGTCAG	ATGCTGTT
PH5_Popham_Beach_ME	TCATGGTCAG	CATGACCTT
PH6_Popham_Beach_ME	TCATGGTCAG	TGCAGTGAGT
